encoder				KEYWORD1
setPin		KEYWORD2
setBandera	KEYWORD2
contadorMemoria	KEYWORD2
reset		KEYWORD2
imprimir	KEYWORD2
getMemoria	KEYWORD2
getVueltas	KEYWORD2
motor				KEYWORD1
setTipo		KEYWORD2
getTipo		KEYWORD2
setPines	KEYWORD2
setAvance	KEYWORD2
getPosicion	KEYWORD2
setVelocidad	KEYWORD2
avanzar		KEYWORD2
retroceder	KEYWORD2
parar		KEYWORD2
getFeedback	KEYWORD2
imprimirPosicion	KEYWORD2
Interfaz			KEYWORD1
imprimirInterfaz	KEYWORD2
interaccionInterfaz	KEYWORD2
inicializar		KEYWORD2
cinInversa	KEYWORD2
getCoordenadas	KEYWORD2
setCoordenadas	KEYWORD2
imprimirAv	KEYWORD2
imprimirVel	KEYWORD2
Trayectoria	KEYWORD2
mismonivel	KEYWORD2
referencia	KEYWORD1
coordenadas 	KEYWORD1
Potenciometro	KEYWORD1
setLimites	KEYWORD2
getAngulo	KEYWORD2
setPorcent_seguridad	KEYWORD2
setpin		KEYWORD2